# # # # #
# 0 0 # #
# @ 0 e #
# 0 0 # #
# # # # #
