# # # # # # # # # # # # # # # #
# e 0 # 0 # # 0 0 # 0 # 0 @ 0 #
# 0 0 0 # 0 0 # 0 0 0 # 0 # 0 #
# 0 # 0 0 # # 0 0 0 # # 0 # # #
# 0 0 # # 0 0 0 0 0 # 0 0 0 # #
# 0 0 0 0 0 0 0 0 0 0 0 0 # 0 #
# # # 0 0 0 0 0 0 # 0 # 0 0 # #
# # 0 # 0 0 0 0 0 0 0 0 0 # 0 #
# 0 0 0 0 0 # 0 # # # # 0 0 0 #
# # # # 0 0 0 0 0 0 0 0 0 0 0 #
# # 0 0 0 0 0 0 0 0 0 0 0 # 0 #
# 0 0 0 0 0 0 # 0 0 # # 0 # 0 #
# # # 0 0 # 0 0 # 0 0 0 0 0 # #
# 0 0 # 0 0 # 0 # # # 0 0 0 # #
# 0 0 0 0 0 0 # 0 # 0 # # 0 # #
# # # # # # # # # # # # # # # #
